30000
180
6
0
0
0
3 3 3 3 3 3 3 1 1 1 3 3 3 3 3 3 3 3 3 1 4 4 4 3 3 3 1 3 3 3 3 3 3 3 3 3 3 1 3 3 10 14 14 14 14 14 14 14 14 12 
1 3 3 3 3 3 3 3 3 3 3 3 3 3 3 1 3 3 3 3 4 4 4 1 3 3 3 3 3 3 3 3 3 3 3 3 3 3 3 3 17 18 18 18 18 18 18 18 18 15 
3 3 3 1 3 3 3 3 3 3 3 3 3 3 3 3 3 3 3 3 4 4 4 1 3 3 3 3 3 1 3 3 3 3 3 3 3 3 3 3 17 18 18 18 18 18 18 18 18 15 
3 3 3 3 1 3 3 3 3 3 3 3 3 3 3 3 3 3 3 3 4 4 4 3 3 3 3 3 3 3 1 3 3 3 3 3 3 3 3 3 17 18 18 18 18 18 18 18 18 15 
3 3 3 3 3 3 3 3 3 3 3 3 3 3 3 3 3 3 1 4 4 4 3 3 3 3 3 3 3 3 3 3 3 3 3 3 3 3 3 1 17 18 18 18 18 18 18 18 18 15 
1 3 3 3 3 3 3 3 3 3 3 1 3 3 3 3 3 3 3 4 4 4 3 3 3 3 3 3 3 3 3 3 3 3 3 3 3 3 3 3 17 18 18 18 18 18 18 18 18 15 
3 3 3 3 3 3 3 3 3 3 3 3 3 3 3 3 3 3 3 4 4 4 1 3 3 3 3 3 3 3 3 3 3 3 3 3 3 3 3 3 17 18 18 18 18 18 18 18 18 15 
3 3 3 3 3 3 3 3 3 3 3 1 3 3 3 3 3 3 3 3 4 4 4 3 3 3 3 3 3 3 3 3 3 3 1 3 3 3 3 3 17 18 18 18 18 18 18 18 18 15 
3 3 3 3 3 3 3 3 3 3 3 3 3 3 3 3 3 3 3 1 4 4 4 3 3 3 3 3 3 3 3 3 3 3 3 3 3 3 3 3 17 18 18 18 18 18 18 18 18 15 
3 3 3 3 3 3 1 3 3 3 3 3 3 3 3 3 3 3 3 3 3 4 4 4 3 3 3 3 3 3 3 3 1 3 3 3 3 3 3 3 17 18 18 18 18 18 18 18 18 15 
3 3 1 3 1 3 3 3 3 3 3 3 3 3 3 3 3 3 3 3 3 4 4 4 1 3 3 3 3 3 3 3 3 3 3 3 3 3 3 3 17 18 18 18 18 18 18 18 18 15 
3 3 3 3 3 3 3 3 3 3 3 3 3 3 3 3 3 3 3 3 3 4 4 4 1 3 3 3 3 3 3 3 3 3 3 3 3 3 3 3 17 18 18 18 18 18 18 18 18 15 
4 4 4 4 3 3 3 3 3 3 3 3 4 2 4 2 4 3 3 3 1 4 4 4 3 3 1 3 3 3 3 3 3 3 3 3 3 3 3 3 17 18 18 18 18 18 18 18 18 15 
4 4 4 4 4 4 4 1 3 4 4 4 4 3 3 3 4 4 4 1 1 4 4 4 3 3 3 3 3 3 3 3 3 3 3 3 3 3 3 3 17 18 18 18 18 18 18 18 18 15 
4 4 4 4 4 4 4 4 4 4 4 4 1 3 3 3 4 4 4 4 4 4 4 3 3 3 3 3 3 3 3 3 3 3 3 3 3 3 3 3 17 18 18 18 18 18 18 18 18 15 
1 1 3 3 4 4 4 4 4 4 4 4 3 3 3 3 4 4 4 4 4 4 4 3 3 3 3 1 3 3 3 3 3 3 3 3 3 3 3 3 17 18 18 18 18 18 18 18 18 15 
3 3 3 3 3 3 3 4 4 3 1 4 4 2 4 2 4 3 3 4 4 1 4 4 3 3 1 3 3 3 3 1 3 3 3 3 3 3 3 3 17 18 18 18 18 18 18 18 18 15 
3 3 3 3 3 3 3 3 3 3 3 3 3 3 1 3 3 3 3 2 3 3 3 4 3 3 3 3 3 3 3 3 3 3 3 3 3 3 3 3 17 18 18 18 18 18 18 18 18 15 
3 3 3 3 3 3 3 3 3 3 3 3 3 3 3 3 3 3 3 4 3 3 3 2 3 3 3 3 3 3 3 3 3 3 3 3 3 3 3 3 17 18 18 18 18 18 18 18 18 15 
3 3 3 3 3 3 3 3 3 3 3 3 3 3 3 3 3 3 3 4 3 3 3 4 3 3 3 3 3 3 3 1 3 3 3 3 3 3 3 3 17 18 18 18 18 18 18 18 18 15 
3 3 3 1 3 3 3 3 3 3 3 3 3 3 1 3 3 3 3 2 3 3 3 4 3 3 3 3 3 3 3 3 3 3 3 3 3 3 3 3 17 18 18 18 18 18 18 18 18 15 
1 3 3 3 3 3 3 3 3 3 3 1 3 3 3 3 3 3 3 4 4 3 3 2 3 3 3 3 3 3 3 1 3 3 3 3 3 3 3 3 17 18 18 18 18 18 18 18 18 15 
3 3 3 3 1 3 3 3 3 3 3 1 3 3 3 3 3 3 3 3 4 4 4 4 3 3 3 3 3 3 3 3 3 3 3 3 3 3 3 1 17 18 18 18 18 18 18 18 18 15 
3 3 3 3 3 3 3 3 3 3 3 3 3 3 3 3 3 3 3 3 4 4 4 3 3 3 1 3 3 3 3 3 3 3 3 3 3 3 3 1 17 18 18 18 18 18 18 18 18 15 
3 3 3 3 3 3 3 1 3 3 3 3 3 3 3 3 3 3 3 3 4 4 4 1 1 3 3 3 3 3 3 3 3 3 3 3 3 3 3 3 17 18 18 18 18 18 18 18 18 15 
3 3 3 3 3 3 3 3 3 3 3 1 3 3 3 3 3 3 3 3 1 4 4 4 1 3 3 3 1 3 3 3 3 3 3 3 3 3 3 3 17 18 18 18 18 18 18 18 18 15 
3 3 3 3 3 3 3 3 3 3 3 3 3 3 3 3 3 3 3 3 3 4 4 4 3 3 3 3 3 3 3 3 3 3 3 3 3 3 3 3 17 18 18 18 18 18 18 18 18 15 
3 3 3 3 3 3 3 3 3 3 3 3 3 1 3 3 3 3 3 3 3 4 4 4 3 3 3 3 3 3 3 3 3 3 3 3 3 3 3 3 17 18 18 18 18 18 18 18 18 15 
3 3 3 3 3 3 3 3 3 3 3 3 3 3 3 3 3 3 3 3 1 4 4 4 3 3 3 3 3 3 3 3 3 3 3 3 3 3 3 3 17 18 18 18 18 18 18 18 18 15 
3 3 3 3 3 1 1 3 3 3 3 3 3 3 3 3 3 3 3 3 3 4 4 4 1 1 3 3 3 3 3 1 3 3 1 3 3 3 3 3 11 16 16 16 16 16 16 16 16 13 
10 14 14 14 14 14 14 14 14 14 14 14 14 14 14 14 14 14 14 14 14 14 14 14 14 14 14 14 14 14 14 14 14 14 14 14 14 14 14 14 14 14 14 14 14 14 14 14 14 12 
17 18 18 18 18 18 18 18 18 18 18 18 18 18 18 18 18 18 18 18 18 18 18 18 18 18 18 18 18 18 18 18 18 18 18 18 18 18 18 18 18 18 18 18 18 18 18 18 18 15 
17 18 18 18 18 18 18 18 18 18 18 18 18 18 18 18 18 18 18 18 18 18 18 18 18 18 18 18 18 18 18 18 18 18 18 18 18 18 18 18 18 18 18 18 18 18 18 18 18 15 
17 18 18 18 18 18 18 18 18 18 18 18 18 18 18 18 18 18 18 18 18 18 18 18 18 18 18 18 18 18 18 18 18 18 18 18 18 18 18 18 18 18 18 18 18 18 18 18 18 15 
17 18 18 18 18 18 18 18 18 18 18 18 18 18 18 18 18 18 18 18 18 18 18 18 18 18 18 18 18 18 18 18 18 18 18 18 18 18 18 18 18 18 18 18 18 18 18 18 18 15 
17 18 18 18 18 18 18 18 18 18 18 18 18 18 18 18 18 18 18 18 18 18 18 18 18 18 18 18 18 18 18 18 18 18 18 18 18 18 18 18 18 18 18 18 18 18 18 18 18 15 
17 18 18 18 18 18 18 18 18 18 18 18 18 18 18 18 18 18 18 18 18 18 18 18 18 18 18 18 18 18 18 18 18 18 18 18 18 18 18 18 18 18 18 18 18 18 18 18 18 15 
11 16 16 16 16 16 16 16 16 16 16 16 16 16 16 16 16 16 16 16 16 16 16 16 16 16 16 16 16 16 16 16 16 16 16 16 16 16 16 16 16 16 16 16 16 16 16 16 16 13 