30000
120
0
0
0
2
4 4 4 4 4 4 4 4 4 4 4 4 0 0 0 0 0 0 4 4 4 4 4 0 0 0 0 0 0 4 4 4 4 4 4 4 4 4 4 4 10 14 14 14 14 14 14 14 14 12 
4 4 4 4 4 4 4 4 4 4 4 0 0 28 28 28 28 0 0 4 4 4 0 0 28 28 28 28 0 0 4 4 4 4 4 4 4 4 4 4 17 18 18 18 18 18 18 18 18 15 
4 4 4 4 4 4 4 4 4 4 0 0 28 28 28 28 28 28 28 28 2 28 28 28 28 28 28 28 28 0 0 4 4 4 4 4 4 4 4 4 17 18 18 18 18 18 18 18 18 15 
4 4 4 4 4 4 4 4 4 0 0 28 28 28 28 28 28 28 28 28 4 28 28 28 28 28 28 28 28 28 0 0 4 4 4 4 4 4 4 4 17 18 18 18 18 18 18 18 18 15 
4 4 4 4 4 4 4 4 0 0 28 28 28 28 28 28 28 28 28 28 4 28 28 28 28 28 28 28 28 28 28 0 0 4 4 4 4 4 4 4 17 18 18 18 18 18 18 18 18 15 
4 4 4 4 4 4 4 0 0 28 28 28 28 28 28 28 28 28 28 28 2 28 28 28 28 28 28 28 28 28 28 28 0 0 4 4 4 4 4 4 17 18 18 18 18 18 18 18 18 15 
4 4 4 4 4 4 0 0 28 28 28 28 28 28 28 28 28 0 0 4 2 4 0 0 28 28 28 28 28 28 28 28 28 0 0 4 4 4 4 4 17 18 18 18 18 18 18 18 18 15 
4 4 4 4 4 0 0 28 28 28 28 28 28 28 28 28 0 4 4 4 2 4 4 4 0 28 28 28 28 28 28 28 28 28 0 0 4 4 4 4 17 18 18 18 18 18 18 18 18 15 
4 4 4 4 0 0 28 28 28 28 28 28 28 28 0 0 4 4 4 4 28 4 4 4 4 0 0 28 28 28 28 28 28 28 28 0 0 4 4 4 17 18 18 18 18 18 18 18 18 15 
4 4 4 0 0 28 28 28 28 28 28 28 28 0 4 4 4 4 4 28 28 28 4 4 4 4 4 0 28 28 28 28 28 28 28 28 0 0 4 4 17 18 18 18 18 18 18 18 18 15 
4 4 4 4 0 0 28 28 28 28 28 28 28 0 4 4 4 4 28 28 28 28 28 4 4 4 4 0 28 28 28 28 28 28 28 0 0 4 4 4 17 18 18 18 18 18 18 18 18 15 
4 4 4 4 4 0 0 28 28 28 28 28 0 4 4 4 4 28 28 28 28 28 28 28 4 4 4 4 0 28 28 28 28 28 0 0 4 4 4 4 17 18 18 18 18 18 18 18 18 15 
4 4 4 4 4 4 0 0 28 28 28 28 0 4 4 4 28 28 28 28 0 28 28 28 28 4 4 4 0 28 28 28 28 0 0 4 4 4 4 4 17 18 18 18 18 18 18 18 18 15 
4 4 4 4 4 4 4 0 28 28 28 28 4 4 4 28 28 28 28 0 4 0 28 28 28 28 4 4 4 28 28 28 28 0 4 4 4 4 4 4 17 18 18 18 18 18 18 18 18 15 
4 4 4 4 4 4 4 4 2 4 4 2 2 2 28 28 28 28 0 4 4 4 0 28 28 28 28 2 2 2 4 4 2 4 4 4 4 4 4 4 17 18 18 18 18 18 18 18 18 15 
4 4 4 4 4 4 4 4 28 28 28 28 4 4 4 28 28 28 28 0 4 0 28 28 28 28 4 4 4 28 28 28 28 4 4 4 4 4 4 4 17 18 18 18 18 18 18 18 18 15 
4 4 4 4 4 4 0 0 28 28 28 28 0 4 4 4 28 28 28 28 0 28 28 28 28 4 4 4 0 28 28 28 28 0 0 4 4 4 4 4 17 18 18 18 18 18 18 18 18 15 
4 4 4 4 4 0 0 28 28 28 28 28 0 4 4 4 4 28 28 28 28 28 28 28 4 4 4 4 0 28 28 28 28 28 0 0 4 4 4 4 17 18 18 18 18 18 18 18 18 15 
4 4 4 4 0 0 28 28 28 28 28 28 28 0 4 4 4 4 28 28 28 28 28 4 4 4 4 0 28 28 28 28 28 28 28 0 0 4 4 4 17 18 18 18 18 18 18 18 18 15 
4 4 4 0 0 28 28 28 28 28 28 28 28 0 4 4 4 4 4 28 28 28 4 4 4 4 4 0 28 28 28 28 28 28 28 28 0 0 4 4 17 18 18 18 18 18 18 18 18 15 
4 4 4 4 0 0 28 28 28 28 28 28 28 28 0 0 4 4 4 4 28 4 4 4 4 0 0 28 28 28 28 28 28 28 28 0 0 4 4 4 17 18 18 18 18 18 18 18 18 15 
4 4 4 4 4 0 0 28 28 28 28 28 28 28 28 28 0 4 4 4 2 4 4 4 0 28 28 28 28 28 28 28 28 28 0 0 4 4 4 4 17 18 18 18 18 18 18 18 18 15 
4 4 4 4 4 4 0 0 28 28 28 28 28 28 28 28 28 0 0 4 2 4 0 0 28 28 28 28 28 28 28 28 28 0 0 4 4 4 4 4 17 18 18 18 18 18 18 18 18 15 
4 4 4 4 4 4 4 0 0 28 28 28 28 28 28 28 28 28 28 28 2 28 28 28 28 28 28 28 28 28 28 28 0 0 4 4 4 4 4 4 17 18 18 18 18 18 18 18 18 15 
4 4 4 4 4 4 4 4 0 0 28 28 28 28 28 28 28 28 28 28 4 28 28 28 28 28 28 28 28 28 28 0 0 4 4 4 4 4 4 4 17 18 18 18 18 18 18 18 18 15 
4 4 4 4 4 4 4 4 4 0 0 28 28 28 28 28 28 28 28 28 4 28 28 28 28 28 28 28 28 28 0 0 4 4 4 4 4 4 4 4 17 18 18 18 18 18 18 18 18 15 
4 4 4 4 4 4 4 4 4 4 0 0 28 28 28 28 28 28 28 28 2 28 28 28 28 28 28 28 28 0 0 4 4 4 4 4 4 4 4 4 17 18 18 18 18 18 18 18 18 15 
4 4 4 4 4 4 4 4 4 4 4 0 0 28 28 28 28 0 0 4 4 4 0 0 28 28 28 28 0 0 4 4 4 4 4 4 4 4 4 4 17 18 18 18 18 18 18 18 18 15 
4 4 4 4 4 4 4 4 4 4 4 4 0 0 28 28 0 0 4 4 4 4 4 0 0 28 28 0 0 4 4 4 4 4 4 4 4 4 4 4 17 18 18 18 18 18 18 18 18 15 
4 4 4 4 4 4 4 4 4 4 4 4 4 0 0 0 0 4 4 4 4 4 4 4 0 0 0 0 4 4 4 4 4 4 4 4 4 4 4 4 11 16 16 16 16 16 16 16 16 13 
10 14 14 14 14 14 14 14 14 14 14 14 14 14 14 14 14 14 14 14 14 14 14 14 14 14 14 14 14 14 14 14 14 14 14 14 14 14 14 14 14 14 14 14 14 14 14 14 14 12 
17 18 18 18 18 18 18 18 18 18 18 18 18 18 18 18 18 18 18 18 18 18 18 18 18 18 18 18 18 18 18 18 18 18 18 18 18 18 18 18 18 18 18 18 18 18 18 18 18 15 
17 18 18 18 18 18 18 18 18 18 18 18 18 18 18 18 18 18 18 18 18 18 18 18 18 18 18 18 18 18 18 18 18 18 18 18 18 18 18 18 18 18 18 18 18 18 18 18 18 15 
17 18 18 18 18 18 18 18 18 18 18 18 18 18 18 18 18 18 18 18 18 18 18 18 18 18 18 18 18 18 18 18 18 18 18 18 18 18 18 18 18 18 18 18 18 18 18 18 18 15 
17 18 18 18 18 18 18 18 18 18 18 18 18 18 18 18 18 18 18 18 18 18 18 18 18 18 18 18 18 18 18 18 18 18 18 18 18 18 18 18 18 18 18 18 18 18 18 18 18 15 
17 18 18 18 18 18 18 18 18 18 18 18 18 18 18 18 18 18 18 18 18 18 18 18 18 18 18 18 18 18 18 18 18 18 18 18 18 18 18 18 18 18 18 18 18 18 18 18 18 15 
17 18 18 18 18 18 18 18 18 18 18 18 18 18 18 18 18 18 18 18 18 18 18 18 18 18 18 18 18 18 18 18 18 18 18 18 18 18 18 18 18 18 18 18 18 18 18 18 18 15 
11 16 16 16 16 16 16 16 16 16 16 16 16 16 16 16 16 16 16 16 16 16 16 16 16 16 16 16 16 16 16 16 16 16 16 16 16 16 16 16 16 16 16 16 16 16 16 16 16 13 