33000
160
4
3
0
0
7 7 7 7 7 7 7 7 7 7 7 7 7 7 7 7 7 7 7 7 7 7 7 7 7 7 7 7 7 7 7 7 7 7 7 7 7 7 7 7 10 14 14 14 14 14 14 14 14 12 
7 7 8 8 6 6 6 6 6 8 8 7 7 7 8 7 7 7 7 7 8 6 6 6 8 8 7 7 7 7 8 6 6 6 8 8 7 7 7 7 17 18 18 18 18 18 18 18 18 15 
7 7 6 6 6 5 6 6 8 7 7 7 7 7 8 7 7 7 7 8 8 6 5 6 6 8 7 7 7 8 6 6 6 6 6 6 8 7 7 7 17 18 18 18 18 18 18 18 18 15 
8 6 6 6 6 6 6 6 7 7 7 7 7 8 6 8 7 7 7 7 8 6 6 6 6 6 8 7 7 8 6 6 5 5 6 6 6 7 7 7 17 18 18 18 18 18 18 18 18 15 
7 6 6 5 6 6 6 8 7 7 7 8 6 6 6 6 6 7 7 7 7 6 6 5 6 6 6 6 7 7 7 6 6 6 5 6 6 6 8 7 17 18 18 18 18 18 18 18 18 15 
5 6 6 6 6 7 8 7 7 7 6 6 6 6 6 6 6 8 7 7 7 6 6 6 6 6 6 6 8 8 7 8 6 6 6 5 6 6 8 7 17 18 18 18 18 18 18 18 18 15 
5 5 7 6 6 8 7 7 7 6 6 6 5 5 6 6 6 6 8 7 7 7 8 6 6 6 6 6 6 8 7 8 6 6 6 5 6 6 8 7 17 18 18 18 18 18 18 18 18 15 
7 7 7 8 8 8 8 7 6 6 6 6 6 6 6 6 6 5 6 7 7 7 7 8 6 6 5 6 6 6 8 7 7 6 6 6 6 6 6 7 17 18 18 18 18 18 18 18 18 15 
7 7 7 7 7 7 7 7 8 6 6 6 5 6 6 5 5 6 6 8 8 7 7 8 6 6 6 5 6 6 8 8 7 6 6 6 6 6 6 7 17 18 18 18 18 18 18 18 18 15 
8 8 7 7 7 7 7 7 7 6 6 6 6 6 6 6 6 6 6 8 7 7 6 6 6 5 6 6 6 6 7 7 8 6 6 6 6 5 6 8 17 18 18 18 18 18 18 18 18 15 
8 8 7 6 5 5 6 7 7 8 6 6 6 6 6 8 7 7 7 7 7 7 6 6 6 5 6 6 6 8 7 7 7 8 8 6 6 6 6 8 17 18 18 18 18 18 18 18 18 15 
7 8 8 6 6 6 6 8 7 7 6 6 6 5 6 8 7 7 7 7 8 7 7 6 6 6 6 8 8 7 7 7 7 8 7 7 6 6 8 7 17 18 18 18 18 18 18 18 18 15 
7 8 6 6 5 6 6 8 7 7 7 8 6 6 7 7 7 7 7 8 8 7 7 7 6 6 6 8 7 7 7 8 7 7 8 7 7 7 7 7 17 18 18 18 18 18 18 18 18 15 
7 8 6 6 6 5 6 6 6 7 7 7 8 8 7 7 7 7 8 6 6 6 7 7 8 8 7 7 7 7 8 6 6 6 6 8 8 8 7 7 17 18 18 18 18 18 18 18 18 15 
7 7 6 6 6 6 6 6 6 6 8 7 7 7 7 7 7 6 6 6 6 6 6 7 8 8 8 7 7 6 6 6 6 6 6 6 6 8 7 7 17 18 18 18 18 18 18 18 18 15 
7 7 6 8 8 6 6 6 6 7 8 8 7 7 8 8 6 6 6 6 5 6 6 7 7 8 7 7 7 6 6 6 6 6 5 6 6 6 7 7 17 18 18 18 18 18 18 18 18 15 
7 7 7 7 8 8 7 5 6 8 8 7 7 7 6 6 6 6 6 6 5 6 6 8 7 7 8 8 6 6 6 5 6 6 6 6 6 6 5 7 17 18 18 18 18 18 18 18 18 15 
7 7 7 8 7 7 7 8 8 7 7 7 7 7 6 6 6 6 6 6 6 6 6 8 8 7 8 6 6 6 6 6 6 6 6 5 6 6 5 7 17 18 18 18 18 18 18 18 18 15 
7 7 7 8 8 7 7 7 7 7 7 7 7 6 6 5 6 6 6 6 6 6 6 6 8 7 7 6 6 5 6 6 6 6 6 6 6 5 7 7 17 18 18 18 18 18 18 18 18 15 
7 7 8 6 6 5 7 7 7 7 7 7 7 6 6 6 6 5 6 6 6 6 6 6 7 7 7 7 5 6 6 5 6 6 6 6 6 7 7 7 17 18 18 18 18 18 18 18 18 15 
7 7 6 6 6 6 5 8 8 7 7 8 6 5 6 6 6 6 6 6 6 6 6 8 7 7 7 7 5 6 6 6 6 6 6 8 7 7 7 7 17 18 18 18 18 18 18 18 18 15 
7 6 6 6 6 6 6 6 8 8 7 8 6 6 6 6 6 6 6 5 6 6 8 7 7 7 7 7 8 6 6 6 6 8 7 7 7 7 8 7 17 18 18 18 18 18 18 18 18 15 
8 6 6 6 5 5 6 6 8 7 7 7 8 6 6 5 6 6 6 5 6 6 8 7 8 7 7 7 7 6 6 6 7 7 7 7 7 7 8 7 17 18 18 18 18 18 18 18 18 15 
7 8 6 6 6 5 6 6 6 6 7 7 7 6 6 5 6 6 6 6 7 7 7 8 8 7 7 7 7 8 8 7 7 7 7 7 8 8 6 7 17 18 18 18 18 18 18 18 18 15 
7 7 7 6 6 6 5 6 6 6 7 7 7 8 6 6 6 6 7 7 7 7 7 6 6 8 7 7 7 7 8 7 7 7 7 5 6 6 6 7 17 18 18 18 18 18 18 18 18 15 
7 7 7 7 6 6 6 6 6 6 7 7 7 7 7 7 7 7 7 7 8 6 6 6 6 6 8 7 7 7 7 7 7 7 5 6 6 6 7 7 17 18 18 18 18 18 18 18 18 15 
7 8 6 6 6 6 6 6 8 8 7 7 8 8 7 7 8 7 7 7 7 5 6 5 6 6 8 7 7 7 7 7 8 6 6 6 6 8 7 7 17 18 18 18 18 18 18 18 18 15 
8 6 6 6 6 5 7 8 7 7 7 7 6 6 8 8 6 5 7 8 6 6 6 5 6 6 6 8 7 7 7 7 8 6 6 6 8 8 7 7 17 18 18 18 18 18 18 18 18 15 
7 7 6 6 5 7 7 7 7 7 7 5 6 6 6 6 6 6 6 6 6 6 6 6 5 6 6 6 8 8 7 8 6 6 6 5 7 7 7 7 17 18 18 18 18 18 18 18 18 15 
7 7 8 8 7 7 7 7 7 7 5 5 5 6 6 6 6 6 6 6 6 6 6 6 6 6 6 7 7 7 7 7 7 7 7 7 7 7 7 7 11 16 16 16 16 16 16 16 16 13 
10 14 14 14 14 14 14 14 14 14 14 14 14 14 14 14 14 14 14 14 14 14 14 14 14 14 14 14 14 14 14 14 14 14 14 14 14 14 14 14 14 14 14 14 14 14 14 14 14 12 
17 18 18 18 18 18 18 18 18 18 18 18 18 18 18 18 18 18 18 18 18 18 18 18 18 18 18 18 18 18 18 18 18 18 18 18 18 18 18 18 18 18 18 18 18 18 18 18 18 15 
17 18 18 18 18 18 18 18 18 18 18 18 18 18 18 18 18 18 18 18 18 18 18 18 18 18 18 18 18 18 18 18 18 18 18 18 18 18 18 18 18 18 18 18 18 18 18 18 18 15 
17 18 18 18 18 18 18 18 18 18 18 18 18 18 18 18 18 18 18 18 18 18 18 18 18 18 18 18 18 18 18 18 18 18 18 18 18 18 18 18 18 18 18 18 18 18 18 18 18 15 
17 18 18 18 18 18 18 18 18 18 18 18 18 18 18 18 18 18 18 18 18 18 18 18 18 18 18 18 18 18 18 18 18 18 18 18 18 18 18 18 18 18 18 18 18 18 18 18 18 15 
17 18 18 18 18 18 18 18 18 18 18 18 18 18 18 18 18 18 18 18 18 18 18 18 18 18 18 18 18 18 18 18 18 18 18 18 18 18 18 18 18 18 18 18 18 18 18 18 18 15 
17 18 18 18 18 18 18 18 18 18 18 18 18 18 18 18 18 18 18 18 18 18 18 18 18 18 18 18 18 18 18 18 18 18 18 18 18 18 18 18 18 18 18 18 18 18 18 18 18 15 
11 16 16 16 16 16 16 16 16 16 16 16 16 16 16 16 16 16 16 16 16 16 16 16 16 16 16 16 16 16 16 16 16 16 16 16 16 16 16 16 16 16 16 16 16 16 16 16 16 13 