26000
90
0
0
3
0
 22 22 22 22 20 20 20 20 20 20 20 20 20 20 20 20 20 20 20 20 20 20 20 20 20 20 20 20 20 20 20 20 20 20 20 20 20 20 22 22 10 14 14 14 14 14 14 14 14 12 
 22 22 22 20 20 20 22 20 20 20 20 20 20 21 21 22 20 20 20 20 20 22 20 20 20 20 20 20 20 20 21 21 22 20 20 20 20 20 22 22 17 18 18 18 18 18 18 18 18 15 
 22 22 20 20 22 20 20 20 20 20 20 20 21 21 21 21 21 21 20 20 20 20 22 20 20 20 22 21 21 20 21 21 21 20 20 20 20 20 20 22 17 18 18 18 18 18 18 18 18 15 
 22 20 20 20 20 20 20 20 21 21 22 21 21 21 21 21 21 21 21 20 20 20 20 20 20 22 22 21 21 21 21 21 21 21 22 20 20 20 20 20 17 18 18 18 18 18 18 18 18 15 
 22 20 20 20 20 20 21 21 21 21 21 21 21 21 21 22 20 21 21 21 20 20 22 20 20 21 21 21 21 21 21 21 21 21 22 20 20 20 20 20 17 18 18 18 18 18 18 18 18 15 
 20 20 20 20 22 21 21 21 21 21 21 21 21 21 22 20 20 21 21 21 22 20 20 20 20 20 21 21 21 21 21 21 21 21 21 20 20 20 20 20 17 18 18 18 18 18 18 18 18 15 
 20 20 20 22 21 21 21 21 21 21 21 21 21 21 21 20 21 21 21 21 22 20 20 20 20 20 20 20 21 21 21 22 20 20 20 20 20 20 20 20 17 18 18 18 18 18 18 18 18 15 
 22 20 20 21 21 21 21 21 21 21 21 21 20 21 21 21 21 21 21 21 21 20 20 20 20 20 20 21 21 21 21 20 20 20 20 22 20 20 20 20 17 18 18 18 18 18 18 18 18 15 
 20 22 20 21 21 21 21 21 21 21 21 20 22 20 21 21 21 21 21 21 21 21 20 20 20 20 20 21 21 21 21 22 22 20 20 20 22 22 20 20 17 18 18 18 18 18 18 18 18 15 
 20 20 20 20 20 21 21 21 21 21 21 20 22 20 21 21 21 22 20 21 21 21 20 20 21 22 20 21 21 21 21 21 21 20 20 20 20 20 20 20 17 18 18 18 18 18 18 18 18 15 
 20 20 20 20 20 22 21 21 21 20 20 20 20 21 21 21 21 20 20 21 21 21 21 20 21 21 22 21 21 21 21 21 21 20 20 20 20 20 20 20 17 18 18 18 18 18 18 18 18 15 
 20 20 20 20 21 22 21 21 21 20 22 20 21 21 21 21 20 22 21 21 21 21 21 21 21 21 21 21 21 21 21 21 21 21 22 20 20 20 20 20 17 18 18 18 18 18 18 18 18 15 
 20 20 20 20 21 21 21 21 21 21 20 21 21 21 21 21 21 21 21 21 21 21 21 22 20 21 21 21 21 21 21 21 21 21 21 20 20 20 20 20 17 18 18 18 18 18 18 18 18 15 
 20 20 20 20 21 21 21 21 21 21 21 21 21 21 21 21 21 21 21 21 21 22 22 20 20 21 21 21 21 21 21 21 21 21 21 20 20 20 20 20 17 18 18 18 18 18 18 18 18 15 
 20 20 20 22 21 21 21 21 20 20 21 21 21 21 21 21 21 21 21 21 20 20 20 20 21 21 21 21 20 22 20 21 21 21 21 21 20 20 20 20 17 18 18 18 18 18 18 18 18 15 
 22 20 20 21 21 21 21 21 20 22 20 21 21 21 21 22 21 21 21 21 20 20 20 20 21 21 21 21 20 22 20 21 21 20 22 21 20 20 20 22 17 18 18 18 18 18 18 18 18 15 
 22 22 20 21 21 21 21 21 21 20 21 21 21 21 21 21 21 21 20 20 20 20 20 20 21 21 21 20 22 20 20 21 21 21 21 21 20 20 22 22 17 18 18 18 18 18 18 18 18 15 
 22 20 20 20 21 20 22 21 21 21 21 21 21 21 21 21 21 21 20 20 20 20 22 21 21 21 21 20 20 21 21 21 21 21 21 21 20 20 22 22 17 18 18 18 18 18 18 18 18 15 
 20 20 20 20 20 20 20 21 21 21 21 21 22 20 21 21 21 20 20 20 20 21 21 21 21 21 21 21 21 21 21 21 21 20 20 20 20 20 20 22 17 18 18 18 18 18 18 18 18 15 
 20 20 20 20 20 22 21 21 21 21 21 21 21 20 20 20 20 20 20 20 20 21 21 21 21 21 21 21 21 21 22 20 20 20 20 20 22 20 20 20 17 18 18 18 18 18 18 18 18 15 
 20 20 20 20 20 20 20 21 21 21 21 21 21 21 22 20 20 20 20 20 21 21 21 21 21 21 21 21 21 21 21 20 20 20 20 22 20 20 20 20 17 18 18 18 18 18 18 18 18 15 
 20 20 20 22 20 20 20 20 21 21 21 21 21 21 21 20 20 22 21 21 21 20 21 21 21 21 21 21 21 21 21 21 20 20 22 20 20 20 20 20 17 18 18 18 18 18 18 18 18 15 
 20 20 20 20 20 22 20 20 21 21 21 21 21 21 21 20 20 21 21 21 21 22 20 21 21 21 21 21 21 21 21 22 20 20 22 20 20 20 20 20 17 18 18 18 18 18 18 18 18 15 
 22 22 20 20 20 20 20 20 22 21 21 21 22 20 20 20 20 21 21 21 22 20 21 21 21 21 21 21 21 21 21 21 20 20 20 20 20 20 20 20 17 18 18 18 18 18 18 18 18 15 
 22 22 20 20 20 21 21 21 22 20 21 22 20 20 20 20 20 20 21 21 20 20 20 21 21 21 21 22 20 21 21 21 21 20 20 20 20 20 20 20 17 18 18 18 18 18 18 18 18 15 
 22 22 21 21 21 21 21 21 21 21 21 21 20 20 22 22 20 20 21 21 20 22 21 21 21 21 21 22 22 21 21 21 21 20 20 20 20 20 20 20 17 18 18 18 18 18 18 18 18 15 
 22 21 21 21 21 21 21 21 21 21 21 20 20 20 22 22 20 20 20 21 21 21 21 21 21 21 21 20 20 21 21 21 22 20 20 20 20 20 20 20 17 18 18 18 18 18 18 18 18 15 
 22 21 21 21 21 21 21 21 21 21 20 20 20 20 20 20 20 20 20 21 21 21 21 20 21 21 21 22 21 21 20 20 20 20 20 20 22 20 20 20 17 18 18 18 18 18 18 18 18 15 
 21 21 21 21 21 22 20 21 20 20 20 20 20 20 20 20 22 20 20 20 21 21 21 20 20 22 21 21 21 20 20 20 20 20 20 20 22 22 20 20 17 18 18 18 18 18 18 18 18 15 
 21 21 21 21 21 20 20 20 20 20 20 20 20 20 20 20 20 20 20 20 20 20 20 20 20 20 20 20 20 20 20 20 20 20 20 22 22 22 22 22 11 16 16 16 16 16 16 16 16 13 
 10 14 14 14 14 14 14 14 14 14 14 14 14 14 14 14 14 14 14 14 14 14 14 14 14 14 14 14 14 14 14 14 14 14 14 14 14 14 14 14 14 14 14 14 14 14 14 14 14 12 
 17 18 18 18 18 18 18 18 18 18 18 18 18 18 18 18 18 18 18 18 18 18 18 18 18 18 18 18 18 18 18 18 18 18 18 18 18 18 18 18 18 18 18 18 18 18 18 18 18 15 
 17 18 18 18 18 18 18 18 18 18 18 18 18 18 18 18 18 18 18 18 18 18 18 18 18 18 18 18 18 18 18 18 18 18 18 18 18 18 18 18 18 18 18 18 18 18 18 18 18 15 
 17 18 18 18 18 18 18 18 18 18 18 18 18 18 18 18 18 18 18 18 18 18 18 18 18 18 18 18 18 18 18 18 18 18 18 18 18 18 18 18 18 18 18 18 18 18 18 18 18 15 
 17 18 18 18 18 18 18 18 18 18 18 18 18 18 18 18 18 18 18 18 18 18 18 18 18 18 18 18 18 18 18 18 18 18 18 18 18 18 18 18 18 18 18 18 18 18 18 18 18 15 
 17 18 18 18 18 18 18 18 18 18 18 18 18 18 18 18 18 18 18 18 18 18 18 18 18 18 18 18 18 18 18 18 18 18 18 18 18 18 18 18 18 18 18 18 18 18 18 18 18 15 
 17 18 18 18 18 18 18 18 18 18 18 18 18 18 18 18 18 18 18 18 18 18 18 18 18 18 18 18 18 18 18 18 18 18 18 18 18 18 18 18 18 18 18 18 18 18 18 18 18 15 
 11 16 16 16 16 16 16 16 16 16 16 16 16 16 16 16 16 16 16 16 16 16 16 16 16 16 16 16 16 16 16 16 16 16 16 16 16 16 16 16 16 16 16 16 16 16 16 16 16 13 
