29500
120
0
5
0
0
4 4 4 4 23 23 23 23 24 24 24 24 23 23 24 23 23 24 24 24 23 23 24 24 4 4 24 23 23 4 4 4 24 24 23 23 23 23 23 23 10 14 14 14 14 14 14 14 14 12 
4 4 4 4 4 23 23 23 23 24 24 24 24 24 24 23 23 24 23 24 24 24 24 4 4 4 24 24 24 24 2 24 24 24 23 24 23 23 23 23 17 18 18 18 18 18 18 18 18 15 
23 4 4 4 4 4 4 23 23 23 23 24 24 24 24 24 24 24 24 24 23 24 24 4 23 4 24 24 24 4 4 4 24 24 24 24 24 24 23 23 17 18 18 18 18 18 18 18 18 15 
23 23 23 4 4 4 4 4 4 23 23 23 24 23 24 24 23 24 23 23 23 24 24 4 4 4 4 24 4 4 4 23 24 24 24 24 24 24 23 23 17 18 18 18 18 18 18 18 18 15 
23 23 23 24 4 4 4 4 4 4 23 23 23 23 24 24 24 24 24 23 23 24 24 24 24 24 4 4 4 23 24 23 24 24 23 23 24 24 24 23 17 18 18 18 18 18 18 18 18 15 
23 23 23 24 24 24 4 4 4 4 4 4 23 23 23 23 24 23 24 24 23 23 24 24 23 24 24 4 4 24 24 24 24 24 23 23 23 24 24 23 17 18 18 18 18 18 18 18 18 15 
23 23 24 24 24 24 24 4 4 4 4 4 4 23 23 23 23 24 24 24 24 23 23 24 24 24 24 24 24 24 24 23 23 24 24 23 23 23 23 23 17 18 18 18 18 18 18 18 18 15 
23 23 24 23 23 24 23 23 23 4 4 4 4 4 4 4 23 23 24 24 24 23 23 23 24 23 24 24 24 24 23 23 23 23 24 24 24 23 23 23 17 18 18 18 18 18 18 18 18 15 
23 23 24 24 23 24 23 23 23 23 4 4 4 4 4 4 4 23 23 24 24 23 23 23 24 24 24 23 23 23 23 23 23 23 24 24 24 23 23 23 17 18 18 18 18 18 18 18 18 15 
23 23 24 24 24 24 24 23 23 23 23 23 4 4 4 4 4 4 23 23 24 23 23 24 24 24 23 23 23 23 23 23 23 23 23 24 24 23 23 23 17 18 18 18 18 18 18 18 18 15 
23 23 24 23 23 24 24 24 24 23 23 23 23 23 23 4 4 4 4 4 24 23 23 24 23 24 23 23 23 23 23 23 23 23 23 23 24 24 24 24 17 18 18 18 18 18 18 18 18 15 
23 23 24 24 24 24 23 23 24 24 23 23 23 23 23 23 4 4 4 4 24 24 24 24 24 23 24 24 23 23 23 23 23 23 23 23 24 24 4 4 17 18 18 18 18 18 18 18 18 15 
23 23 23 24 24 24 23 23 24 24 24 24 23 23 23 23 23 4 4 4 24 24 24 24 24 24 24 24 24 23 23 23 23 23 23 24 24 4 4 4 17 18 18 18 18 18 18 18 18 15 
23 23 23 23 23 24 23 23 23 24 23 24 24 23 23 23 23 4 4 4 4 24 23 23 23 23 24 24 24 24 23 23 23 23 23 24 24 4 4 4 17 18 18 18 18 18 18 18 18 15 
23 23 23 23 24 24 23 23 23 24 24 24 24 24 23 23 23 4 4 4 4 4 23 23 23 23 23 24 23 24 23 23 23 23 23 24 24 4 4 4 17 18 18 18 18 18 18 18 18 15 
23 23 23 23 24 24 23 23 23 23 24 24 23 24 24 24 23 23 4 4 4 4 4 4 23 23 23 24 24 24 24 23 23 23 23 24 24 24 24 4 17 18 18 18 18 18 18 18 18 15 
23 23 23 23 24 23 23 23 23 23 23 24 24 24 24 24 23 23 23 4 4 4 4 4 4 4 23 23 23 24 24 24 23 23 23 23 24 24 24 23 17 18 18 18 18 18 18 18 18 15 
23 24 24 24 24 24 23 23 23 23 23 23 23 23 24 23 23 23 23 4 23 23 4 4 4 4 4 4 23 23 24 24 23 23 23 24 24 24 23 23 17 18 18 18 18 18 18 18 18 15 
23 24 24 24 24 24 24 23 23 23 23 23 23 23 24 24 23 23 4 4 23 24 23 4 4 4 4 4 4 24 24 23 23 23 24 24 24 23 23 23 17 18 18 18 18 18 18 18 18 15 
23 24 4 4 4 24 24 23 23 23 24 24 23 23 24 24 24 23 4 4 23 24 24 23 23 4 4 4 4 4 24 24 23 24 24 23 23 23 23 23 17 18 18 18 18 18 18 18 18 15 
23 4 4 4 24 24 24 23 23 23 24 24 24 23 23 24 24 4 4 23 24 24 24 24 24 23 4 4 4 4 24 24 24 24 23 23 23 23 23 23 17 18 18 18 18 18 18 18 18 15 
4 4 4 4 4 24 24 24 24 24 24 24 23 23 23 24 24 2 2 24 24 24 24 24 24 24 23 4 4 4 4 24 24 24 23 23 23 23 23 23 17 18 18 18 18 18 18 18 18 15 
4 4 4 4 4 24 24 24 23 24 24 24 23 23 23 24 24 4 4 4 23 24 24 24 24 24 24 24 2 2 2 2 24 24 24 24 24 23 23 23 17 18 18 18 18 18 18 18 18 15 
4 4 4 4 4 24 24 23 23 23 24 23 23 23 24 24 23 23 4 4 4 23 23 23 24 24 23 23 4 4 4 4 4 24 23 23 24 24 23 23 17 18 18 18 18 18 18 18 18 15 
4 4 4 24 24 24 24 23 23 23 24 24 23 24 24 23 23 23 23 4 4 23 4 4 4 24 23 4 4 4 4 4 4 4 23 23 23 24 23 23 17 18 18 18 18 18 18 18 18 15 
4 24 24 24 24 24 23 23 23 23 24 24 24 24 24 23 23 23 23 23 4 4 4 4 4 23 23 4 4 23 4 4 4 4 4 23 24 24 23 23 17 18 18 18 18 18 18 18 18 15 
4 24 24 24 23 23 23 23 23 23 24 24 24 24 24 24 24 24 24 23 23 4 4 4 4 4 4 4 23 23 23 4 4 4 4 4 24 24 24 23 17 18 18 18 18 18 18 18 18 15 
4 24 24 23 23 23 23 23 23 23 23 23 24 24 24 24 24 4 24 23 23 23 23 23 4 4 4 23 4 4 4 4 23 4 4 4 23 24 24 23 17 18 18 18 18 18 18 18 18 15 
23 24 24 23 23 23 23 23 23 23 23 23 23 23 23 4 4 4 24 23 23 23 23 23 23 4 4 4 4 4 4 4 4 4 4 4 4 24 24 23 17 18 18 18 18 18 18 18 18 15 
23 24 23 23 23 23 23 23 23 23 23 23 23 23 23 23 4 4 24 23 23 23 23 23 23 23 4 23 4 23 23 4 4 4 4 4 4 24 24 23 11 16 16 16 16 16 16 16 16 13 
10 14 14 14 14 14 14 14 14 14 14 14 14 14 14 14 14 14 14 14 14 14 14 14 14 14 14 14 14 14 14 14 14 14 14 14 14 14 14 14 14 14 14 14 14 14 14 14 14 12 
17 18 18 18 18 18 18 18 18 18 18 18 18 18 18 18 18 18 18 18 18 18 18 18 18 18 18 18 18 18 18 18 18 18 18 18 18 18 18 18 18 18 18 18 18 18 18 18 18 15 
17 18 18 18 18 18 18 18 18 18 18 18 18 18 18 18 18 18 18 18 18 18 18 18 18 18 18 18 18 18 18 18 18 18 18 18 18 18 18 18 18 18 18 18 18 18 18 18 18 15 
17 18 18 18 18 18 18 18 18 18 18 18 18 18 18 18 18 18 18 18 18 18 18 18 18 18 18 18 18 18 18 18 18 18 18 18 18 18 18 18 18 18 18 18 18 18 18 18 18 15 
17 18 18 18 18 18 18 18 18 18 18 18 18 18 18 18 18 18 18 18 18 18 18 18 18 18 18 18 18 18 18 18 18 18 18 18 18 18 18 18 18 18 18 18 18 18 18 18 18 15 
17 18 18 18 18 18 18 18 18 18 18 18 18 18 18 18 18 18 18 18 18 18 18 18 18 18 18 18 18 18 18 18 18 18 18 18 18 18 18 18 18 18 18 18 18 18 18 18 18 15 
17 18 18 18 18 18 18 18 18 18 18 18 18 18 18 18 18 18 18 18 18 18 18 18 18 18 18 18 18 18 18 18 18 18 18 18 18 18 18 18 18 18 18 18 18 18 18 18 18 15 
11 16 16 16 16 16 16 16 16 16 16 16 16 16 16 16 16 16 16 16 16 16 16 16 16 16 16 16 16 16 16 16 16 16 16 16 16 16 16 16 16 16 16 16 16 16 16 16 16 13 
