31000
150
5
2
0
1
4 4 26 25 25 25 25 25 25 4 4 27 27 25 25 25 26 26 26 26 25 25 26 26 26 26 26 26 26 26 26 26 27 27 26 26 25 25 25 25 10 14 14 14 14 14 14 14 14 12
4 26 26 26 27 25 25 27 27 4 4 25 26 26 26 25 26 27 27 26 26 26 26 25 27 26 26 26 26 26 26 26 26 26 26 26 27 25 27 25 17 18 18 18 18 18 18 18 18 15 
27 26 26 26 26 26 26 25 27 4 4 27 26 27 26 26 26 27 25 26 26 26 26 25 25 26 25 25 27 27 25 26 26 26 26 26 26 27 27 25 17 18 18 18 18 18 18 18 18 15 
25 26 26 26 26 25 26 26 4 4 4 26 26 26 26 26 26 26 26 26 25 27 26 27 25 26 25 26 26 26 25 26 26 26 25 26 26 26 26 25 17 18 18 18 18 18 18 18 18 15 
25 26 26 26 26 27 26 27 2 2 26 26 26 26 26 26 26 26 26 25 26 25 26 26 26 26 26 25 26 26 25 26 26 25 27 25 26 26 27 25 17 18 18 18 18 18 18 18 18 15 
25 26 26 26 26 25 25 25 4 4 4 27 26 25 25 27 26 26 26 25 26 27 26 26 26 26 26 27 27 25 26 26 26 27 25 26 26 26 25 27 17 18 18 18 18 18 18 18 18 15 
25 26 26 27 27 25 25 25 25 4 4 4 27 25 26 25 27 26 26 26 25 25 25 25 26 26 26 26 26 26 26 26 27 25 26 26 26 25 25 27 17 18 18 18 18 18 18 18 18 15 
27 27 25 27 25 26 26 26 26 26 2 2 26 26 26 25 25 27 26 26 26 27 25 27 25 27 26 26 26 26 26 25 27 25 26 26 26 27 27 25 17 18 18 18 18 18 18 18 18 15 
4 4 27 26 26 26 26 26 25 25 4 4 26 27 26 27 25 27 26 27 26 27 27 25 25 27 27 25 25 27 25 25 27 25 26 26 26 25 27 25 15 18 18 18 18 18 18 18 18 15 
4 25 26 26 26 26 26 25 25 4 4 4 26 27 26 26 25 25 26 26 26 25 26 26 26 26 26 26 25 25 26 26 26 25 26 26 26 26 25 27 17 18 18 18 18 18 18 18 18 15 
4 25 26 26 26 26 25 25 27 4 4 26 26 26 26 26 25 26 26 26 26 26 26 26 27 25 25 26 25 27 26 25 26 26 27 25 26 26 25 25 17 18 18 18 18 18 18 18 18 15 
4 25 26 26 26 25 27 27 4 4 4 27 26 26 26 26 27 26 26 25 26 26 26 26 27 26 27 26 27 26 26 25 26 26 25 25 26 26 25 27 17 18 18 18 18 18 18 18 18 15 
27 25 25 26 25 25 4 4 4 4 4 4 26 26 4 2 4 2 4 25 27 25 25 26 25 25 27 26 27 26 27 27 26 27 27 26 26 26 27 27 17 18 18 18 18 18 18 18 18 15 
27 27 25 4 4 4 4 4 4 4 4 4 4 4 4 2 4 2 4 4 4 27 26 26 26 26 26 26 25 26 26 26 26 25 25 26 26 25 25 25 17 18 18 18 18 18 18 18 18 15 
4 4 4 4 4 4 4 4 4 4 4 4 4 4 4 26 27 26 4 4 4 4 27 26 27 26 27 27 25 25 25 26 26 25 26 26 26 26 25 27 17 18 18 18 18 18 18 18 18 15 
4 4 4 4 4 4 4 4 4 4 4 4 4 4 4 26 26 26 25 27 4 4 27 26 26 26 26 27 27 25 25 26 26 25 26 26 26 26 26 26 17 18 18 18 18 18 18 18 18 15 
25 27 4 4 4 4 4 4 4 4 4 4 4 4 4 26 26 26 26 25 4 4 26 26 26 26 26 25 25 27 25 26 26 27 26 26 25 25 25 26 17 18 18 18 18 18 18 18 18 15 
25 27 27 26 26 27 4 4 4 4 4 4 4 4 27 26 26 27 26 25 4 4 27 26 26 26 25 26 26 25 27 26 27 25 26 26 27 26 25 26 17 18 18 18 18 18 18 18 18 15 
25 25 25 26 25 25 27 4 4 4 4 26 27 25 25 26 26 26 26 25 4 4 4 27 25 27 25 26 26 26 27 26 25 27 26 26 27 27 25 26 17 18 18 18 18 18 18 18 18 15 
25 25 26 26 26 25 27 27 27 26 4 26 25 25 25 25 26 26 25 25 4 4 4 4 26 26 26 26 25 26 25 27 25 25 26 26 26 26 26 26 17 18 18 18 18 18 18 18 18 15 
27 25 26 26 26 26 25 25 25 26 26 26 25 26 26 25 26 26 26 25 27 27 4 4 4 4 26 26 27 26 26 26 26 27 25 27 26 26 27 25 17 18 18 18 18 18 18 18 18 15 
27 26 26 26 26 26 26 26 26 26 26 25 25 26 25 26 26 25 27 26 25 27 4 4 4 4 4 26 26 26 25 27 26 27 27 25 26 26 26 25 17 18 18 18 18 18 18 18 18 15 
25 25 26 26 26 26 25 25 26 27 25 25 26 26 25 26 26 27 25 26 26 25 25 26 26 2 2 26 26 26 26 26 26 25 26 26 26 26 26 26 17 18 18 18 18 18 18 18 18 15 
27 27 25 25 27 25 25 25 27 27 25 25 26 26 26 25 26 26 26 25 26 26 26 26 26 4 4 4 27 27 26 25 27 25 26 26 26 26 26 25 17 18 18 18 18 18 18 18 18 15 
27 25 25 27 25 25 26 25 26 26 27 27 25 25 25 25 26 26 25 25 26 26 26 26 26 4 4 4 4 26 26 4 4 27 27 26 26 26 25 25 17 18 18 18 18 18 18 18 18 15 
25 25 26 26 26 26 26 25 26 26 26 25 25 25 26 26 26 26 25 25 26 26 26 25 25 25 4 4 4 4 2 4 4 4 4 26 27 27 27 27 17 18 18 18 18 18 18 18 18 15 
25 26 26 26 25 25 25 26 26 26 26 26 26 26 26 26 25 25 26 26 26 26 27 27 25 4 4 4 4 4 2 4 4 4 4 2 4 4 4 4 17 18 18 18 18 18 18 18 18 15 
27 4 26 27 27 26 27 26 26 26 26 26 26 26 25 26 26 25 4 4 25 25 25 4 4 4 4 4 4 4 26 27 26 27 4 2 4 4 4 4 17 18 18 18 18 18 18 18 18 15 
4 4 4 4 27 26 26 4 27 26 4 4 26 27 4 25 25 4 4 4 4 4 4 4 4 4 4 4 4 25 26 26 26 26 27 26 4 4 4 4 17 18 18 18 18 18 18 18 18 15 
4 25 25 4 4 4 4 4 4 4 4 4 4 4 4 4 4 4 4 4 25 27 25 4 4 4 4 4 4 25 26 26 26 26 26 26 27 4 4 4 11 16 16 16 16 16 16 16 16 13
10 14 14 14 14 14 14 14 14 14 14 14 14 14 14 14 14 14 14 14 14 14 14 14 14 14 14 14 14 14 14 14 14 14 14 14 14 14 14 14 14 14 14 14 14 14 14 14 14 12 
17 18 18 18 18 18 18 18 18 18 18 18 18 18 18 18 18 18 18 18 18 18 18 18 18 18 18 18 18 18 18 18 18 18 18 18 18 18 18 18 18 18 18 18 18 18 18 18 18 15 
17 18 18 18 18 18 18 18 18 18 18 18 18 18 18 18 18 18 18 18 18 18 18 18 18 18 18 18 18 18 18 18 18 18 18 18 18 18 18 18 18 18 18 18 18 18 18 18 18 15 
17 18 18 18 18 18 18 18 18 18 18 18 18 18 18 18 18 18 18 18 18 18 18 18 18 18 18 18 18 18 18 18 18 18 18 18 18 18 18 18 18 18 18 18 18 18 18 18 18 15 
17 18 18 18 18 18 18 18 18 18 18 18 18 18 18 18 18 18 18 18 18 18 18 18 18 18 18 18 18 18 18 18 18 18 18 18 18 18 18 18 18 18 18 18 18 18 18 18 18 15 
17 18 18 18 18 18 18 18 18 18 18 18 18 18 18 18 18 18 18 18 18 18 18 18 18 18 18 18 18 18 18 18 18 18 18 18 18 18 18 18 18 18 18 18 18 18 18 18 18 15 
17 18 18 18 18 18 18 18 18 18 18 18 18 18 18 18 18 18 18 18 18 18 18 18 18 18 18 18 18 18 18 18 18 18 18 18 18 18 18 18 18 18 18 18 18 18 18 18 18 15 
11 16 16 16 16 16 16 16 16 16 16 16 16 16 16 16 16 16 16 16 16 16 16 16 16 16 16 16 16 16 16 16 16 16 16 16 16 16 16 16 16 16 16 16 16 16 16 16 16 13 
 
 
  
 