30000
120
0
0
0
5
28 28 28 28 28 28 28 28 28 28 28 28 28 28 28 28 28 0 28 28 28 28 28 28 28 28 28 28 28 28 28 28 28 28 28 28 28 28 28 28 10 14 14 14 14 14 14 14 14 12 
28 28 28 28 28 28 28 28 28 28 28 0 28 28 28 28 28 28 28 28 28 28 28 28 28 28 0 28 28 28 28 28 28 28 28 28 0 28 28 28 17 18 18 18 18 18 18 18 18 15
28 28 28 28 28 28 28 28 28 28 28 28 28 28 0 28 28 28 0 28 28 28 28 28 28 28 28 28 28 28 28 28 28 28 28 28 28 28 28 28 17 18 18 18 18 18 18 18 18 15 
28 28 28 0 28 28 28 28 28 28 0 28 28 28 28 28 28 28 28 28 28 0 28 28 28 0 28 28 28 28 28 28 28 28 28 28 28 28 28 28 17 18 18 18 18 18 18 18 18 15 
28 28 28 28 28 28 28 28 28 28 28 28 28 0 28 28 28 28 28 28 28 28 28 28 28 28 28 28 28 28 28 28 28 28 28 28 28 28 28 28 17 18 18 18 18 18 18 18 18 15 
28 28 28 28 28 28 28 28 28 28 28 28 28 28 0 28 28 0 28 28 28 28 28 28 28 28 28 28 28 0 28 28 28 28 28 28 28 28 0 28 17 18 18 18 18 18 18 18 18 15 
28 28 28 28 28 28 28 28 28 0 28 28 28 28 28 28 28 28 28 28 28 28 28 0 28 28 28 28 28 28 28 28 28 28 28 28 28 28 28 28 17 18 18 18 18 18 18 18 18 15 
28 28 28 28 28 28 0 28 28 28 28 28 28 28 28 28 28 28 28 28 28 28 0 0 28 28 28 28 28 28 28 28 28 28 28 28 28 28 28 28 17 18 18 18 18 18 18 18 18 15 
28 28 28 28 28 28 0 28 28 28 28 28 0 28 28 28 4 4 4 4 28 28 28 28 28 28 28 28 28 28 28 0 28 28 28 28 28 28 28 28 17 18 18 18 18 18 18 18 18 15 
28 28 28 28 28 28 28 28 28 28 28 0 28 28 28 4 4 4 0 4 0 0 28 28 28 28 28 28 0 28 28 28 28 28 28 28 28 28 28 28 17 18 18 18 18 18 18 18 18 15 
28 28 28 28 28 28 28 28 28 28 28 28 28 28 0 4 4 4 4 4 4 4 4 4 28 28 28 28 28 28 28 28 28 28 0 28 28 28 28 28 17 18 18 18 18 18 18 18 18 15 
28 28 28 28 28 28 28 28 28 0 0 28 0 4 4 4 4 4 4 4 4 4 4 4 4 0 0 28 28 28 28 28 28 28 28 28 28 28 28 28 17 18 18 18 18 18 18 18 18 15 
28 28 28 0 28 28 28 28 28 28 28 28 4 4 4 4 4 4 4 4 4 4 4 4 4 4 4 0 28 28 28 28 0 28 28 28 28 28 28 28 17 18 18 18 18 18 18 18 18 15 
28 28 28 28 28 28 28 28 28 28 28 28 28 4 4 4 4 4 4 4 4 4 4 4 4 4 4 28 28 28 28 28 28 28 28 28 28 28 28 28 17 18 18 18 18 18 18 18 18 15 
28 28 28 28 28 28 28 28 0 28 28 28 28 28 4 4 4 4 4 4 4 4 4 4 4 4 4 4 28 28 28 0 28 28 28 28 28 28 28 28 17 18 18 18 18 18 18 18 18 15 
28 28 28 28 28 28 28 28 28 28 0 28 28 28 4 4 4 4 4 4 4 4 4 4 4 4 4 4 28 28 28 28 28 28 28 28 28 28 28 28 17 18 18 18 18 18 18 18 18 15 
28 28 28 28 28 28 28 28 28 28 28 28 28 0 4 4 4 4 4 4 4 4 4 4 4 4 4 28 28 28 28 28 28 28 28 28 28 28 28 28 17 18 18 18 18 18 18 18 18 15 
28 28 28 28 28 28 28 28 28 28 28 0 28 0 4 4 4 4 4 4 4 4 4 4 4 4 4 0 28 28 0 28 0 28 28 28 28 28 28 28 17 18 18 18 18 18 18 18 18 15 
28 28 28 28 0 28 28 28 28 28 28 28 28 4 4 4 4 4 4 4 4 4 4 4 4 4 4 4 28 28 28 28 28 28 28 28 28 28 28 28 17 18 18 18 18 18 18 18 18 15 
28 28 28 28 0 28 28 28 28 28 28 28 4 4 4 4 4 4 4 4 4 4 4 4 4 0 28 28 0 28 28 28 28 28 0 28 28 28 28 28 17 18 18 18 18 18 18 18 18 15 
28 28 28 28 28 28 28 28 28 28 28 28 4 4 4 4 0 28 28 4 4 4 0 28 28 28 28 28 28 28 28 28 28 28 28 28 28 28 28 28 17 18 18 18 18 18 18 18 18 15 
0 28 28 28 28 28 28 28 28 28 28 0 4 4 4 4 28 28 28 4 4 28 28 28 0 28 28 28 28 28 28 28 28 0 28 28 28 28 28 28 17 18 18 18 18 18 18 18 18 15 
28 28 28 28 28 28 28 28 28 28 28 28 0 4 4 28 28 28 4 4 4 28 28 28 28 28 28 28 0 28 28 28 28 28 28 28 28 28 28 28 17 18 18 18 18 18 18 18 18 15 
28 28 28 28 28 28 28 28 28 28 28 28 28 28 4 28 28 28 4 0 28 28 28 28 0 28 28 28 28 28 28 28 28 28 28 28 28 28 28 28 17 18 18 18 18 18 18 18 18 15 
28 28 28 28 28 28 28 28 28 28 28 28 28 28 0 28 28 28 28 28 28 28 28 28 28 28 28 28 28 28 28 28 28 28 28 28 28 28 28 28 17 18 18 18 18 18 18 18 18 15 
28 28 0 28 28 28 28 28 28 28 28 0 28 28 0 28 28 0 28 28 28 0 28 28 28 28 28 28 28 28 28 28 28 28 28 28 28 28 28 28 17 18 18 18 18 18 18 18 18 15 
28 28 28 28 28 28 28 28 28 28 28 28 28 28 28 28 0 28 28 28 28 28 0 28 28 28 28 28 28 28 28 28 28 0 28 28 28 28 28 28 17 18 18 18 18 18 18 18 18 15 
28 28 28 28 28 28 28 0 28 28 28 28 0 28 28 28 28 28 28 28 28 28 0 28 28 28 28 28 28 28 28 28 0 28 28 28 28 28 28 28 17 18 18 18 18 18 18 18 18 15 
28 28 28 28 28 28 28 28 28 28 28 28 28 28 28 28 28 28 28 28 28 28 28 28 28 28 28 28 28 28 28 28 28 28 28 28 28 28 28 28 17 18 18 18 18 18 18 18 18 15 
28 28 28 28 28 28 28 28 28 28 28 28 28 28 28 28 28 28 28 28 28 28 28 28 28 28 28 28 28 28 28 28 28 28 28 28 28 28 28 28 11 16 16 16 16 16 16 16 16 13 
10 14 14 14 14 14 14 14 14 14 14 14 14 14 14 14 14 14 14 14 14 14 14 14 14 14 14 14 14 14 14 14 14 14 14 14 14 14 14 14 14 14 14 14 14 14 14 14 14 12 
17 18 18 18 18 18 18 18 18 18 18 18 18 18 18 18 18 18 18 18 18 18 18 18 18 18 18 18 18 18 18 18 18 18 18 18 18 18 18 18 18 18 18 18 18 18 18 18 18 15 
17 18 18 18 18 18 18 18 18 18 18 18 18 18 18 18 18 18 18 18 18 18 18 18 18 18 18 18 18 18 18 18 18 18 18 18 18 18 18 18 18 18 18 18 18 18 18 18 18 15 
17 18 18 18 18 18 18 18 18 18 18 18 18 18 18 18 18 18 18 18 18 18 18 18 18 18 18 18 18 18 18 18 18 18 18 18 18 18 18 18 18 18 18 18 18 18 18 18 18 15 
17 18 18 18 18 18 18 18 18 18 18 18 18 18 18 18 18 18 18 18 18 18 18 18 18 18 18 18 18 18 18 18 18 18 18 18 18 18 18 18 18 18 18 18 18 18 18 18 18 15 
17 18 18 18 18 18 18 18 18 18 18 18 18 18 18 18 18 18 18 18 18 18 18 18 18 18 18 18 18 18 18 18 18 18 18 18 18 18 18 18 18 18 18 18 18 18 18 18 18 15 
17 18 18 18 18 18 18 18 18 18 18 18 18 18 18 18 18 18 18 18 18 18 18 18 18 18 18 18 18 18 18 18 18 18 18 18 18 18 18 18 18 18 18 18 18 18 18 18 18 15 
11 16 16 16 16 16 16 16 16 16 16 16 16 16 16 16 16 16 16 16 16 16 16 16 16 16 16 16 16 16 16 16 16 16 16 16 16 16 16 16 16 16 16 16 16 16 16 16 16 13 
