29500
200
0
0
0
5
23 24 23 23 23 23 23 23 23 23 23 23 23 24 24 23 24 23 24 23 23 23 23 23 23 23 23 24 24 24 24 24 24 23 24 24 24 24 24 23 10 14 14 14 14 14 14 14 14 12 
23 24 24 24 24 24 24 24 24 24 24 24 23 23 24 23 24 23 24 24 24 24 24 24 24 24 24 24 23 23 23 23 24 23 24 23 23 23 24 23 17 18 18 18 18 18 18 18 18 15 
23 23 23 23 23 23 23 24 23 24 23 24 24 23 24 23 24 23 23 23 23 23 23 23 23 24 23 23 23 24 24 23 24 24 24 24 24 23 24 24 17 18 18 18 18 18 18 18 18 15 
24 24 24 24 24 24 24 24 23 24 23 23 24 23 24 23 24 24 24 24 24 24 24 24 23 24 23 24 24 24 23 23 23 23 23 23 23 23 23 24 17 18 18 18 18 18 18 18 18 15 
24 23 23 23 23 23 23 24 23 24 23 23 24 23 24 23 23 23 23 23 23 23 23 24 23 24 23 24 23 23 23 24 24 24 24 24 24 24 23 24 17 18 18 18 18 18 18 18 18 15 
24 23 24 24 24 24 23 24 23 24 23 24 24 23 24 23 24 24 24 24 24 24 23 24 23 24 23 24 24 23 23 23 23 24 23 23 23 23 23 24 17 18 18 18 18 18 18 18 18 15 
24 23 24 23 23 24 23 24 23 24 23 24 23 23 24 23 24 23 23 23 23 24 23 24 23 24 23 23 24 23 24 24 24 24 24 24 23 24 24 24 17 18 18 18 18 18 18 18 18 15 
24 23 24 24 23 24 23 23 23 24 23 24 23 24 24 23 24 24 24 24 23 24 24 24 23 24 24 23 24 23 24 23 23 24 23 24 23 23 24 23 17 18 18 18 18 18 18 18 18 15 
24 23 23 24 23 24 24 24 23 24 23 23 23 24 23 23 23 23 23 24 23 24 23 23 23 23 24 23 24 23 23 23 23 23 23 24 24 23 24 23 17 18 18 18 18 18 18 18 18 15 
24 24 23 24 23 23 23 24 23 24 24 24 24 24 24 24 24 24 23 24 23 24 23 24 24 24 24 23 24 24 24 24 24 23 23 23 24 23 24 23 17 18 18 18 18 18 18 18 18 15 
23 24 23 24 24 23 24 24 23 24 23 23 23 23 23 23 23 24 24 24 23 24 23 24 23 23 23 23 23 23 23 23 24 23 24 24 24 24 24 23 17 18 18 18 18 18 18 18 18 15 
23 24 23 23 24 23 24 23 23 24 23 23 24 24 24 24 24 24 23 23 23 24 23 24 24 24 23 24 24 24 23 24 24 24 24 23 24 23 24 23 17 18 18 18 18 18 18 18 18 15 
23 24 24 23 24 23 24 24 23 24 24 23 23 23 23 23 23 23 23 23 24 24 23 23 23 24 24 24 23 24 23 24 23 23 23 23 24 23 23 23 17 18 18 18 18 18 18 18 18 15 
23 23 24 23 24 23 23 24 23 23 24 24 24 24 23 24 24 24 24 24 24 24 24 24 23 23 23 23 23 24 23 24 24 24 24 24 24 24 24 24 17 18 18 18 18 18 18 18 18 15 
24 24 24 23 24 24 23 24 23 23 23 23 23 24 23 24 24 23 23 23 23 23 23 24 23 24 24 24 24 24 23 23 23 23 23 23 24 23 23 23 17 18 18 18 18 18 18 18 18 15 
24 23 24 23 23 24 23 24 23 24 24 24 24 24 23 23 23 23 24 24 24 23 23 24 23 24 23 23 23 24 23 24 24 24 24 24 24 23 24 24 17 18 18 18 18 18 18 18 18 15 
24 23 24 24 23 24 23 24 23 24 23 23 23 24 24 24 24 24 24 23 23 23 23 24 23 24 23 23 23 23 23 24 23 23 23 23 23 23 23 24 17 18 18 18 18 18 18 18 18 15 
24 23 23 24 23 24 23 24 23 24 24 24 23 23 23 23 23 23 23 23 24 24 24 24 23 24 24 24 24 24 23 24 23 24 24 24 24 24 23 24 17 18 18 18 18 18 18 18 18 15 
24 24 23 24 23 24 23 24 23 23 23 24 24 24 23 24 24 24 24 24 24 23 23 24 23 23 24 23 23 24 23 24 23 24 23 23 23 24 23 24 17 18 18 18 18 18 18 18 18 15 
23 24 24 24 23 24 23 24 23 23 23 23 23 24 24 24 23 23 23 24 23 24 24 24 23 23 24 23 24 24 23 24 23 24 23 24 24 24 23 24 17 18 18 18 18 18 18 18 18 15 
23 24 23 24 23 24 23 24 24 24 24 24 23 23 23 24 24 24 23 24 23 24 23 23 23 23 24 23 23 23 23 24 23 24 23 24 23 23 23 23 17 18 18 18 18 18 18 18 18 15 
23 24 23 24 23 24 23 23 23 23 23 24 24 23 23 23 23 24 23 24 23 24 24 24 24 24 24 24 24 24 24 24 24 24 23 24 24 24 24 23 17 18 18 18 18 18 18 18 18 15 
23 23 23 24 23 24 24 24 24 24 23 23 24 24 24 24 23 24 23 24 23 23 23 23 23 23 23 23 23 23 23 23 23 23 23 23 23 23 24 23 17 18 18 18 18 18 18 18 18 15 
24 24 24 24 23 23 23 23 23 24 24 23 24 23 23 24 23 24 23 24 24 24 24 23 23 24 24 24 24 24 24 24 24 24 23 24 24 24 24 24 17 18 18 18 18 18 18 18 18 15 
23 23 23 24 24 24 24 24 23 23 24 23 24 23 24 24 23 24 23 23 23 23 24 23 23 24 23 23 23 23 23 23 23 24 23 23 23 23 23 24 17 18 18 18 18 18 18 18 18 15 
24 24 24 24 23 23 24 23 23 23 24 23 24 23 24 23 23 24 24 24 23 24 24 24 24 24 24 24 24 23 24 24 23 24 24 24 24 24 24 24 17 18 18 18 18 18 18 18 18 15 
23 23 23 23 23 23 24 23 24 24 24 24 24 23 24 23 24 24 23 24 23 23 23 23 23 23 23 24 23 23 23 24 23 24 23 23 23 23 23 23 17 18 18 18 18 18 18 18 18 15 
23 24 24 24 24 24 24 23 24 23 23 24 24 23 24 23 23 23 24 24 24 24 24 24 24 24 24 24 24 24 24 24 23 24 24 24 24 23 24 24 17 18 18 18 18 18 18 18 18 15 
23 24 23 23 23 23 23 23 24 23 24 24 23 23 24 24 24 24 24 23 23 23 23 23 23 24 23 23 23 23 23 23 23 23 24 23 24 23 24 23 17 18 18 18 18 18 18 18 18 15 
23 24 24 24 24 24 24 24 24 23 24 23 23 24 24 23 23 23 23 23 24 24 24 24 24 24 24 24 24 24 24 24 24 24 24 23 24 24 24 23 11 16 16 16 16 16 16 16 16 13 
10 14 14 14 14 14 14 14 14 14 14 14 14 14 14 14 14 14 14 14 14 14 14 14 14 14 14 14 14 14 14 14 14 14 14 14 14 14 14 14 14 14 14 14 14 14 14 14 14 12 
17 18 18 18 18 18 18 18 18 18 18 18 18 18 18 18 18 18 18 18 18 18 18 18 18 18 18 18 18 18 18 18 18 18 18 18 18 18 18 18 18 18 18 18 18 18 18 18 18 15 
17 18 18 18 18 18 18 18 18 18 18 18 18 18 18 18 18 18 18 18 18 18 18 18 18 18 18 18 18 18 18 18 18 18 18 18 18 18 18 18 18 18 18 18 18 18 18 18 18 15 
17 18 18 18 18 18 18 18 18 18 18 18 18 18 18 18 18 18 18 18 18 18 18 18 18 18 18 18 18 18 18 18 18 18 18 18 18 18 18 18 18 18 18 18 18 18 18 18 18 15 
17 18 18 18 18 18 18 18 18 18 18 18 18 18 18 18 18 18 18 18 18 18 18 18 18 18 18 18 18 18 18 18 18 18 18 18 18 18 18 18 18 18 18 18 18 18 18 18 18 15 
17 18 18 18 18 18 18 18 18 18 18 18 18 18 18 18 18 18 18 18 18 18 18 18 18 18 18 18 18 18 18 18 18 18 18 18 18 18 18 18 18 18 18 18 18 18 18 18 18 15 
17 18 18 18 18 18 18 18 18 18 18 18 18 18 18 18 18 18 18 18 18 18 18 18 18 18 18 18 18 18 18 18 18 18 18 18 18 18 18 18 18 18 18 18 18 18 18 18 18 15 
11 16 16 16 16 16 16 16 16 16 16 16 16 16 16 16 16 16 16 16 16 16 16 16 16 16 16 16 16 16 16 16 16 16 16 16 16 16 16 16 16 16 16 16 16 16 16 16 16 13 