31000
150
3
2
0
1
25 25 25 25 25 26 26 26 26 26 26 26 26 26 25 25 25 4 4 4 25 25 25 26 26 26 26 26 26 26 26 26 26 26 25 25 25 25 25 25 10 14 14 14 14 14 14 14 14 12 
25 25 25 25 26 26 26 26 26 26 26 26 26 26 26 25 25 4 4 4 25 25 26 26 26 26 26 25 25 25 26 26 26 26 25 25 25 25 25 25 17 18 18 18 18 18 18 18 18 15 
25 25 25 26 26 26 26 26 25 25 25 25 26 26 26 26 25 4 4 4 25 26 26 26 26 25 25 25 25 26 26 26 26 26 26 25 25 25 25 26 17 18 18 18 18 18 18 18 18 15 
25 25 26 26 26 26 25 25 25 25 25 25 26 26 26 26 4 4 4 4 26 26 26 26 25 25 25 25 26 26 26 26 26 26 26 26 25 25 26 26 17 18 18 18 18 18 18 18 18 15 
25 25 26 26 26 25 25 25 25 25 25 26 26 26 26 4 4 4 4 26 26 26 26 26 25 25 25 25 25 26 26 26 26 26 26 26 25 25 26 26 17 18 18 18 18 18 18 18 18 15 
25 26 26 26 26 25 25 25 25 25 25 26 26 26 4 4 4 4 4 26 26 26 26 26 25 25 25 25 25 25 26 26 26 26 26 25 25 25 26 26 17 18 18 18 18 18 18 18 18 15 
25 26 26 26 26 25 25 25 25 26 26 26 26 26 4 4 4 4 26 26 26 26 26 26 25 25 25 25 25 25 25 26 26 26 25 25 25 26 26 26 17 18 18 18 18 18 18 18 18 15 
25 26 26 25 25 25 25 26 26 26 26 26 26 4 4 4 4 26 26 26 26 26 25 25 25 25 26 26 25 25 25 25 25 25 25 25 25 26 26 26 17 18 18 18 18 18 18 18 18 15 
26 26 26 25 25 25 26 26 26 26 26 26 4 4 4 4 26 26 26 26 25 25 25 25 25 25 26 26 25 25 25 25 25 25 25 25 26 26 26 26 17 18 18 18 18 18 18 18 18 15 
26 26 26 25 25 26 26 26 26 26 26 4 4 4 4 26 26 26 26 25 25 25 25 25 25 26 26 26 26 26 26 25 25 25 26 26 26 26 26 25 17 18 18 18 18 18 18 18 18 15 
26 26 26 25 25 26 26 26 26 26 26 4 4 4 26 26 26 26 25 25 25 25 25 25 26 26 26 26 26 26 26 26 25 25 26 26 26 26 25 25 17 18 18 18 18 18 18 18 18 15 
26 26 25 25 25 26 26 26 26 26 4 4 4 26 26 26 26 25 25 25 25 25 25 26 26 26 26 26 26 26 26 26 26 26 26 26 26 25 25 25 17 18 18 18 18 18 18 18 18 15 
26 26 25 25 25 25 26 26 26 26 2 2 2 26 26 26 26 25 25 25 25 25 26 26 26 26 26 26 4 4 26 26 26 26 26 26 25 25 25 25 17 18 18 18 18 18 18 18 18 15 
26 26 26 25 25 25 26 26 26 26 4 4 4 26 26 26 26 25 25 25 25 26 26 26 26 26 26 4 4 4 4 26 26 26 26 26 25 25 25 25 17 18 18 18 18 18 18 18 18 15 
26 26 26 26 25 25 25 26 26 26 26 4 4 4 26 26 26 26 26 25 25 26 26 26 26 4 4 4 4 4 4 4 26 26 26 26 25 25 25 25 17 18 18 18 18 18 18 18 18 15 
25 25 26 26 26 25 25 26 26 26 26 4 4 4 4 4 26 26 26 26 26 26 26 26 4 4 4 4 26 4 4 4 26 26 26 26 25 25 25 25 17 18 18 18 18 18 18 18 18 15 
25 25 25 26 26 25 25 25 26 26 26 26 4 4 4 4 4 26 26 26 26 26 26 4 4 4 4 26 26 26 4 4 4 26 26 26 26 25 25 25 17 18 18 18 18 18 18 18 18 15 
25 25 25 26 26 25 25 25 26 26 26 26 26 26 4 4 4 4 26 26 26 26 4 4 4 4 26 26 26 26 26 4 4 4 26 26 26 26 25 25 17 18 18 18 18 18 18 18 18 15 
25 26 26 26 26 26 25 25 25 26 26 26 26 26 26 4 4 4 4 26 26 4 4 4 4 26 26 26 26 26 26 4 4 4 26 26 26 26 25 25 17 18 18 18 18 18 18 18 18 15 
25 26 26 26 26 26 25 25 25 25 26 26 26 26 26 26 4 4 4 2 4 4 4 4 26 26 26 25 25 26 26 26 4 4 4 26 26 26 25 25 17 18 18 18 18 18 18 18 18 15 
25 25 26 26 26 26 25 25 25 25 25 26 26 26 26 26 26 4 4 2 4 4 4 26 26 26 25 25 25 25 26 26 4 4 4 26 26 26 25 25 17 18 18 18 18 18 18 18 18 15 
25 25 25 25 26 26 25 25 25 25 25 25 26 26 26 26 26 26 26 26 4 4 26 26 26 25 25 25 25 25 26 26 26 4 4 4 26 26 25 25 17 18 18 18 18 18 18 18 18 15 
25 25 25 26 26 25 25 25 25 25 25 25 25 25 26 26 26 26 26 26 26 26 26 26 26 25 25 25 25 25 26 26 26 2 2 2 26 26 26 25 17 18 18 18 18 18 18 18 18 15 
25 26 26 26 26 25 25 25 25 25 25 25 25 25 25 26 26 26 26 26 26 26 26 25 25 25 25 25 25 25 26 26 26 4 4 4 26 26 26 25 17 18 18 18 18 18 18 18 18 15 
26 26 26 26 25 25 25 25 25 25 25 25 25 25 25 25 25 25 26 26 26 25 25 25 25 25 25 25 25 25 26 26 26 4 4 4 26 26 26 25 17 18 18 18 18 18 18 18 18 15 
26 26 26 25 25 25 26 26 26 26 26 26 25 25 25 25 25 25 26 26 25 25 25 25 25 25 25 26 26 26 26 26 26 4 4 4 26 26 26 26 17 18 18 18 18 18 18 18 18 15 
26 26 26 25 25 26 26 26 26 26 26 26 26 26 25 25 25 25 25 25 25 25 25 25 25 26 26 26 26 26 26 26 4 4 4 26 26 26 26 26 17 18 18 18 18 18 18 18 18 15 
26 26 26 25 26 26 26 25 25 26 26 26 26 26 25 25 25 25 25 25 25 25 25 25 26 26 26 26 26 26 26 4 4 4 4 26 26 26 25 25 17 18 18 18 18 18 18 18 18 15 
26 26 26 26 26 26 25 25 25 25 25 26 26 26 26 26 26 25 25 25 25 25 25 26 26 26 26 26 26 26 4 4 4 4 26 26 26 25 25 25 17 18 18 18 18 18 18 18 18 15 
26 26 26 26 26 26 25 25 25 25 25 25 26 26 26 26 26 25 25 25 25 25 26 26 26 26 26 26 26 4 4 4 4 26 26 26 25 25 25 25 11 16 16 16 16 16 16 16 16 13 
10 14 14 14 14 14 14 14 14 14 14 14 14 14 14 14 14 14 14 14 14 14 14 14 14 14 14 14 14 14 14 14 14 14 14 14 14 14 14 14 14 14 14 14 14 14 14 14 14 12 
17 18 18 18 18 18 18 18 18 18 18 18 18 18 18 18 18 18 18 18 18 18 18 18 18 18 18 18 18 18 18 18 18 18 18 18 18 18 18 18 18 18 18 18 18 18 18 18 18 15 
17 18 18 18 18 18 18 18 18 18 18 18 18 18 18 18 18 18 18 18 18 18 18 18 18 18 18 18 18 18 18 18 18 18 18 18 18 18 18 18 18 18 18 18 18 18 18 18 18 15 
17 18 18 18 18 18 18 18 18 18 18 18 18 18 18 18 18 18 18 18 18 18 18 18 18 18 18 18 18 18 18 18 18 18 18 18 18 18 18 18 18 18 18 18 18 18 18 18 18 15 
17 18 18 18 18 18 18 18 18 18 18 18 18 18 18 18 18 18 18 18 18 18 18 18 18 18 18 18 18 18 18 18 18 18 18 18 18 18 18 18 18 18 18 18 18 18 18 18 18 15 
17 18 18 18 18 18 18 18 18 18 18 18 18 18 18 18 18 18 18 18 18 18 18 18 18 18 18 18 18 18 18 18 18 18 18 18 18 18 18 18 18 18 18 18 18 18 18 18 18 15 
17 18 18 18 18 18 18 18 18 18 18 18 18 18 18 18 18 18 18 18 18 18 18 18 18 18 18 18 18 18 18 18 18 18 18 18 18 18 18 18 18 18 18 18 18 18 18 18 18 15 
11 16 16 16 16 16 16 16 16 16 16 16 16 16 16 16 16 16 16 16 16 16 16 16 16 16 16 16 16 16 16 16 16 16 16 16 16 16 16 16 16 16 16 16 16 16 16 16 16 13 